150 150 150 150 150 150 150 148 155 156 156 156 156 156 156 156 156 156 156 156 156 156 156 156 156 156 156 156 154 139 139 139 139 139 139 139 139 155 156 156 156 156 156 156 156 156 156 156 156 156 156 156 156 156 156 156 156 156 154 166 166 166 166 166 166 166 166
150 150 150 150 150 150 150 148 163 157 157 157 157 165 164 153 152 153 152 153 152 153 152 153 152 153 152 153 138 139 139 139 139 139 139 139 139 151 153 152 153 152 153 152 153 152 153 152 153 152 153 160 161 157 157 157 157 157 158 166 166 166 166 166 166 166 166
150 150 150 150 150 150 150 148 162 142 142 142 142 141 135 136 137 136 137 136 137 136 137 136 137 136 137 136 134 139 139 139 139 139 139 139 139 135 136 137 136 137 136 137 136 137 136 137 136 137 136 134 140 142 142 142 142 142 159 166 166 166 166 166 166 166 166
150 150 150 150 150 150 150 148 162 142 142 142 142 141 135 136 137 136 137 136 137 136 137 136 137 136 137 136 134 139 139 139 133 133 139 139 139 135 136 137 136 137 136 137 136 137 136 137 136 137 136 134 140 142 142 142 142 142 159 166 166 166 166 166 166 166 166
150 150 150 150 150 150 150 148 162 142 142 142 142 141 135 136 137 136 137 136 137 136 137 136 137 136 137 136 134 139 139 139 133 133 139 139 139 135 136 137 136 137 136 137 136 137 136 137 136 137 136 134 140 142 142 142 142 142 159 166 166 166 166 166 166 166 166
150 150 150 150 150 150 150 148 162 142 142 142 142 141 135 136 137 136 137 136 137 136 137 136 137 136 137 136 134 139 139 139 133 133 139 139 139 135 136 137 136 137 136 137 136 137 136 137 136 137 136 134 140 142 142 142 142 142 159 166 166 166 166 166 166 166 166
150 150 150 150 150 150 150 148 110 100 100 100 100 100 100 100 100 100 100 100 100 100 100 100 100 100 100 100 100 100 100 100 100 100 100 100 100 100 100 100 100 100 100 100 100 100 100 100 100 100 100 100 100 100 100 100 100 100 112 190 195 198 182 251 187 166 166
150 150 150 150 150 150 150 148 102 101 101 101 101 101 101 101 101 101 101 101 101 101 101 101 101 101 101 101 101 101 101 101 127 128 101 101 101 101 101 101 101 101 101 101 101 101 101 101 101 101 101 101 101 101 101 101 101 127 103 191 196 199 183 184 189 166 166
150 150 150 150 150 150 150 148 113 114 114 114 114 114 114 114 114 114 114 114 114 114 114 114 114 114 114 114 114 114 114 114 132 132 114 114 114 114 114 114 114 114 114 114 114 114 114 114 114 114 114 114 114 114 114 114 114 102 103 192 196 200 184 184 189 166 166
150 150 150 150 150 150 150 148 113 114 114 114 114 114 114 114 114 114 114 114 114 114 114 114 114 114 114 114 114 114 114 114 132 132 114 114 114 114 114 114 114 114 114 114 114 114 114 114 114 114 114 114 114 114 114 114 114 102 103 193 196 201 185 184 189 166 166
150 150 150 150 150 150 150 148 113 114 114 114 114 114 116 115 115 115 115 115 115 115 115 115 115 115 115 115 115 115 115 115 125 126 115 115 115 115 115 115 115 115 115 115 115 115 115 115 115 115 115 115 115 115 108 114 114 102 103 194 197 202 186 252 188 166 166
150 150 150 150 150 150 150 148 113 114 114 114 114 114 114 114 114 114 114 114 114 114 114 114 114 114 114 114 114 114 114 114 132 132 114 114 114 114 114 114 114 114 114 114 114 114 114 114 114 114 114 114 114 114 113 114 114 102 103 167 172 177 182 251 187 166 166
150 150 150 150 150 150 150 148 113 114 114 114 114 114 114 114 114 114 114 114 114 114 114 114 114 114 114 114 114 114 114 114 132 132 114 114 114 114 114 114 114 114 114 114 114 114 114 114 114 114 114 114 114 114 113 114 114 102 103 168 173 178 183 184 189 166 166
150 150 150 150 150 150 150 148 113 114 145 114 145 114 106 115 115 123 115 115 115 115 115 115 115 115 115 115 115 115 115 115 125 126 115 115 115 115 115 115 115 115 115 115 115 115 115 115 123 115 115 108 114 114 113 114 114 102 103 169 174 179 184 184 189 166 166
150 150 150 150 150 150 150 148 113 114 145 114 145 114 113 150 150 113 114 114 145 114 114 145 114 114 145 114 114 145 114 114 102 103 114 114 145 114 114 145 114 114 145 114 114 145 114 114 113 150 150 113 114 114 113 114 114 102 103 170 175 180 185 184 189 166 166
150 150 150 150 150 150 150 148 113 114 145 114 145 114 113 150 150 113 114 114 145 114 114 145 114 114 145 114 114 145 114 114 102 103 114 114 145 114 114 145 114 114 145 114 114 145 114 114 113 150 150 113 114 114 113 114 114 102 103 171 176 181 186 252 188 166 166
150 150 150 150 150 150 150 148 113 114 145 114 145 114 105 115 115 107 114 114 145 114 114 145 114 114 145 114 114 145 114 114 102 103 114 114 145 114 114 145 114 114 145 114 114 145 114 114 105 115 115 107 114 114 119 114 114 102 103 203 208 198 182 251 187 166 166
150 150 150 150 150 150 150 148 113 114 145 114 145 114 114 114 114 114 114 114 114 114 114 114 114 114 114 114 114 114 114 114 132 132 114 114 114 114 114 114 114 114 114 114 114 114 114 114 114 114 114 114 114 145 114 145 114 102 103 204 209 199 239 184 189 166 166
150 150 150 150 150 150 150 148 113 114 145 114 145 114 114 114 114 114 114 114 114 114 114 114 114 114 114 114 114 114 114 114 132 132 114 114 114 114 114 114 114 114 114 114 114 114 114 114 114 114 114 114 114 145 114 145 114 102 103 205 210 199 239 184 189 166 166
150 150 150 150 150 150 150 148 113 114 145 114 145 114 114 114 114 114 114 114 114 114 114 114 114 114 114 114 114 114 114 114 132 132 114 114 114 114 114 114 114 114 114 114 114 114 114 114 114 114 114 114 114 145 114 145 114 102 103 205 210 201 239 184 189 166 166
150 150 150 150 150 150 150 148 113 114 145 114 145 114 106 115 115 117 114 114 114 114 114 118 114 114 145 114 114 145 114 114 102 103 114 114 145 114 114 145 114 114 118 114 114 114 114 114 116 115 115 108 114 145 114 145 114 102 103 206 211 201 239 184 189 166 166
150 150 150 150 150 150 150 148 113 114 145 114 145 114 113 114 114 114 114 114 114 114 114 113 114 114 145 114 114 145 114 114 102 103 114 114 145 114 114 145 114 114 113 114 114 114 114 114 114 114 114 113 114 145 114 145 114 102 103 207 212 202 186 252 188 166 166
150 150 150 150 150 150 150 148 113 114 145 114 145 114 113 114 114 114 114 114 114 114 114 113 114 114 145 114 114 145 114 114 102 103 114 114 145 114 114 145 114 114 113 114 114 114 114 114 114 114 114 113 114 145 114 145 114 102 103 190 195 198 182 251 187 166 166
150 150 150 150 150 150 150 148 113 114 145 114 145 114 113 144 144 144 114 114 114 114 114 121 115 115 115 115 115 115 115 115 125 126 115 115 115 115 115 115 115 115 120 114 114 114 114 114 144 144 144 113 114 145 114 145 114 102 103 191 196 199 183 184 189 166 166
150 150 150 150 150 150 150 148 113 114 145 114 145 114 113 114 114 114 114 114 114 114 114 113 114 114 145 114 114 145 114 114 102 103 114 114 145 114 114 145 114 114 113 114 114 114 114 114 114 114 114 113 114 145 114 145 114 102 103 192 196 200 184 184 189 166 166
150 150 150 150 150 150 150 148 113 114 145 114 145 114 113 114 114 114 114 114 114 114 114 113 114 114 145 114 114 145 114 114 102 103 114 114 145 114 114 145 114 114 113 114 114 114 114 114 114 114 114 113 114 145 114 145 114 102 103 193 196 201 185 184 189 166 166
150 150 150 150 150 150 150 148 113 114 145 114 145 114 113 144 144 144 114 114 114 114 114 119 114 114 145 114 114 145 114 114 102 103 114 114 145 114 114 145 114 114 119 114 114 114 114 114 144 144 144 113 114 145 114 145 114 102 103 194 197 202 186 252 188 166 166
150 150 150 150 150 150 150 148 113 114 145 114 145 114 113 114 114 114 114 114 114 114 114 114 114 114 114 114 114 114 114 114 132 132 114 114 114 114 114 114 114 114 114 114 114 114 114 114 114 114 114 113 114 145 114 145 114 102 103 203 240 246 182 251 187 166 166
150 150 150 150 150 150 150 148 113 114 145 114 145 114 113 114 114 114 114 114 114 114 114 114 114 114 114 114 114 114 114 114 132 132 114 114 114 114 114 114 114 114 114 114 114 114 114 114 114 114 114 113 114 145 114 145 114 102 103 204 241 247 239 184 189 166 166
150 150 150 150 150 150 150 148 113 114 145 114 145 114 121 115 115 108 114 114 114 114 114 114 114 114 114 114 114 114 114 114 132 132 114 114 114 114 114 114 114 114 114 114 114 114 114 114 106 115 115 120 114 145 114 145 114 102 103 205 242 248 239 184 189 166 166
150 150 150 150 150 150 150 148 113 114 145 114 145 114 113 150 150 113 114 114 145 114 114 145 114 114 145 114 114 145 114 114 102 103 114 114 145 114 114 145 114 114 145 114 114 145 114 114 113 150 150 113 114 145 114 145 114 102 103 213 243 249 239 184 189 166 166
150 150 150 150 150 150 150 148 113 114 145 114 145 114 113 150 150 113 114 114 145 114 114 145 114 114 145 114 114 145 114 114 102 103 114 114 145 114 114 145 114 114 145 114 114 145 114 114 113 150 150 113 114 145 114 145 114 102 103 245 244 250 239 184 255 256 256
150 150 150 150 150 150 150 148 113 114 145 114 145 114 113 150 150 113 114 114 145 114 114 145 114 114 145 114 114 145 114 114 102 103 114 114 145 114 114 145 114 114 145 114 114 145 114 114 113 150 150 113 114 145 114 145 114 102 103 238 236 237 239 184 184 184 184
150 150 150 150 150 150 150 148 113 114 145 114 145 114 105 115 115 122 115 115 115 115 115 115 115 115 115 115 115 115 115 115 125 126 115 115 115 115 115 115 115 115 115 115 115 115 115 115 122 115 115 107 114 145 114 145 114 102 103 230 231 232 233 234 234 234 234
150 150 150 150 150 150 150 148 113 114 114 114 114 114 114 114 114 114 114 114 114 114 114 114 114 114 114 114 114 114 114 114 132 132 114 114 114 114 114 114 114 114 114 114 114 114 114 114 114 114 114 114 114 114 114 114 114 102 103 224 225 226 227 228 228 228 228
150 150 150 150 150 150 150 148 113 114 114 114 114 114 114 114 114 114 114 114 114 114 114 114 114 114 114 114 114 114 114 114 132 132 114 114 114 114 114 114 114 114 114 114 114 114 114 114 114 114 114 114 114 114 114 114 114 102 103 217 218 219 223 229 257 257 257
148 148 148 148 148 148 148 148 113 114 114 114 114 114 110 100 100 100 100 100 100 100 100 100 100 100 100 100 100 100 100 100 129 130 100 100 100 100 100 100 100 100 100 100 100 100 100 100 100 100 100 112 114 114 114 114 114 102 103 215 216 220 221 222 258 258 258
115 115 115 115 115 115 115 115 107 114 114 114 114 114 102 128 101 101 101 101 101 101 101 101 101 101 101 101 101 101 101 101 101 101 101 101 101 101 101 101 101 101 101 101 101 101 101 101 101 101 127 103 114 114 114 114 114 102 130 115 115 115 115 115 115 115 115
114 114 114 114 114 114 114 146 146 146 146 146 146 146 109 111 146 146 146 146 146 146 146 146 146 146 146 146 146 146 146 146 146 146 146 146 146 146 146 146 146 146 146 146 146 146 146 146 146 146 109 111 114 114 114 114 114 102 254 114 114 145 114 114 145 114 114
114 114 114 114 114 114 114 114 114 114 114 114 114 114 146 146 114 114 114 114 114 114 114 114 114 114 114 114 114 114 114 114 114 114 114 114 114 114 114 114 114 114 114 114 114 114 114 114 114 114 146 146 146 146 146 146 146 109 254 114 114 145 114 114 145 114 114
114 114 114 114 114 114 114 114 114 114 114 114 114 114 114 114 114 114 114 114 114 114 114 114 114 114 114 114 114 114 114 114 114 114 114 114 114 114 114 114 114 114 114 114 114 114 114 114 114 114 114 114 114 114 114 114 114 146 146 146 146 146 146 146 146 146 146
114 114 114 114 114 114 114 114 114 114 114 114 114 114 114 114 114 114 114 114 114 114 114 114 114 114 114 114 114 114 114 114 114 114 114 114 114 114 114 114 114 114 114 114 114 114 114 114 114 114 114 114 114 114 114 114 114 114 114 114 114 114 114 114 114 114 114
114 114 114 114 114 114 114 114 114 114 114 114 114 114 114 114 114 114 114 114 114 114 114 114 114 114 114 114 114 114 114 114 114 114 114 114 114 114 114 114 114 114 114 114 114 114 114 114 114 114 114 114 114 114 114 114 114 114 114 114 114 114 114 114 114 114 114
114 114 114 114 114 114 114 114 114 114 114 114 114 114 114 114 114 114 114 114 114 114 114 114 114 114 114 114 114 114 114 114 114 114 114 114 114 114 114 114 114 114 114 114 114 114 114 114 114 114 114 114 114 114 114 114 114 114 114 114 114 114 114 114 114 114 114
114 114 114 114 114 114 114 114 114 114 114 114 114 114 114 114 114 114 114 114 114 114 114 114 114 114 114 114 114 114 114 114 114 114 114 114 114 114 114 114 114 114 114 114 114 114 114 114 114 114 114 114 114 114 114 114 114 114 114 114 114 114 114 114 114 114 114
114 114 114 114 114 114 114 114 114 114 114 114 114 114 114 114 114 114 114 114 114 114 114 114 114 114 114 114 114 114 114 114 114 114 114 114 114 114 114 114 114 114 114 114 114 114 114 114 114 114 114 114 114 114 114 114 114 114 114 114 114 114 114 114 114 114 114